111111111111
111111111111
111111111111
111111111111
111111101111
100000000111
111110000001
100100000001
100000000001
100000000001
100000000001
100000000001
111111111111
