11111111111111111
11111111111111111
11111111111111111
11111111111111111
11111011111111111
10000011111111111
10000011111111111
10000001100000001
10000000000000001
10111100000000001
10110000001111101
10000000000010001
10000000000000001
10000000000000001
10000000000000001
11000000000000011
11100000000000111
11110000000001111
11111111111111111
