1111111111
1111111111
1111111111
1111111111
1110001111
1000001001
1111111001
1100000001
1000000001
1000000001
1000000001
1000000001
1000000001
1000000001
1111111111
