11111111111111111111111111111111111111
10000000000000000000000000000011111111
10000000000000000000000000000000000001
10000000000000001111100100000000000001
10000000000000001101100100000000000001
10000000000000001101100100000000000011
10000000000000001101100100000000000010
10000000011100001101100100000000000010
10000000011100001101111100000000000010
10000000011100000000000100000000000010
10000000000000000000000100000000000010
10000000000000000001111100000000000110
10000000000000000000000000000000000100
10000000000000000000000000000000000100
10000000000000000000000000000000000100
10000000000000000000000000000000000100
10000000000000000000000000000000000100
10011111111110000011111000000000001000
11111111111111111111111000000000001000
11111111111111111111111100000000001000
00000000000000000000011111000000011000
00000000000000000000000000111111110000
