111111111111111111111111111111111111111100000111111111111
111111111111111111111111111111111111111100000111111111111
111111111111111111111111111111111111111100000111111111111
111111111111111111111111111111111111111100000111111111111
111111111111111111111111111111111111111100000111111111111
111111111111011111111111111111100000000000000000000000001
111111111111011111111111111111101111111000000111111111111
111111111111011111111111111111101111111000000111111111111
111111111111011111111111111111101111111000000111111100001
111111111111001111111111111111101000001000000100000100001
111111111111000000000111111111100000000000000000000000001
111111111111000000000011111111000000000000000000000000001
111111111111000000000001000010000000000000000000000000001
111111111111000000000000000000000000000000000000000000001
111111111111000000000000000000000000000000000000000000001
111111111111000000000000000000000000000000000000000000001
111111111111000000011000000000000000000000000000000000001
111111111111000000000000000000000000000000000000000000001
111111111111000000000000000000000000000000000000000111111
111111111111000000000000000000000000000000000000000111111
111111111110000000000000000000000000000000000000000111111
111111111110000000000000000000000000000000000000000111111
111111111110000000000000000000000000000000000000000111111
111111111110000000000000000000000011111110000000000111111
111111111110111111110010000000000011111110000000000111111
111111111110111111100010000000000011111110000000000111111
111111111110111111100010000000000011111110111111100111111
111111111110000000000000000000100010000010111111100111111
111111111110000000000000000000000000000000000000000111111
100000000000000000000000000000000000000000000000000111111
101111111000000000000000000000000000000000000000000111111
101111111000000000000000000000000000000000000000100111111
101111111000000000011100000000000000000000000000000111111
101000001000000000000000000000000000000000000000000111111
100000000000000001000001000000000000000000000000000111111
100000000000000001000001000000000000000000000000000111111
100000000000000000000000000000111111111110000000000111111
100000000000100000000000000000111111111110111111110111111
100000000000000000000000000000111111100000111111110111111
100000000000000000000000000000100000100000111111110111111
100000000000000000000000000000000000000000000000000111111
100000000000000000000000000000000000000000000000000111111
100000000000000000000000000000000000000000000000000111111
111111111111111111111111110000000000000000000000000111111
111111111111111111111111110000000000000000000000000111111
111111111111111111111111110000000000000000000000000111111
111111111111111111111111110000000000000000000000000111111
111111111111111111111111110000000000000000000000000111111
111111111111111111111111110000000000000000000000000111111
111111111111111111111111111111111111111111111111111111111
