000000000001111111111111111111111111111100000111111111111
11;rgb:1e1e/1e1e/1e1e000000000001000000000000000000000000000100000100000000001
000000000001000000000000000000000000000100000100000000001
000000000001000000000000000000000000000100000100000000001
000000000001111111111111111111111111111100000111111111111
000000000001011111111111111111100000000000000000000000001
000000000001011111111111111111101111111000000111111111111
000000000001011111111111111111101111111000000111111111111
000000000001011111111111111111101111111000000111111100001
000000000001001111111111111111101000001000000100000100001
000000000001000000000111111111100000000000000000000000001
000000000001000000000011111111000000000000000000000000001
000000000001000000000001000010000000000000000000000000001
000000000001000000000000000000000000000000000000000000001
000000000001000000000000000000000000000000000000000000001
000000000011000000000000000000000000000000000000000000001
000000000011000000011000000000000000000000000000000000001
000000000011000000000000000000000000000000000000000000001
000000000011000000000000000000000000000000000000000111111
000000000011000000000000000000000000000000000000000100000
000000000010000000000000000000000000000000000000000100000
000000000010000000000000000000000000000000000000000100000
000000000010000000000000000000000000000000000000000100000
000000000010000000000000000000000011111110000000000100000
111111111110111111110010000000000011111110000000000100000
100000000010111111100010000000000011111110000000000100000
100000000010111111100010000000000011111110111111100100000
100000000010000000000000000000100010000010111111100100000
111111111110000000000000000000000000000000000000000100000
100000000000000000000000000000000000000000000000000100000
101111111000000000000000000000000000000000000000000100000
101111111000000000000000000000000000000000000000100100000
101111111000000000011100000000000000000000000000000100000
101000001000000000000000000000000000000000000000000100000
100000000000000001000001000000000000000000000000000100000
100000000000000001000001000000000000000000000000000100000
100000000000000000000000000000111111111110000000000100000
100000000000100000000000000000111111111110111111110100000
100000000000000000000000000000111111100000111111110100000
100000000000000000000000000000100000100000111111110100000
100000000000000000000000000000000000000000000000000100000
100000000000000000000000000000000000000000000000000100000
100000000000000000000000000000000000000000000000000100000
111111111111111111111111110000000000000000000000000100000
000000000000000000000000010000000000000000000000000100000
000000000000000000000000010000000000000000000000000100000
000000000000000000000000010000000000000000000000000100000
000000000000000000000000010000000000000000000000000100000
000000000000000000000000010000000000000000000000000100000
000000000000000000000000011111111111111111111111111100000
