111111111111111111111111111111111111111111111111111111111111111111111111111111111111111111111111111111111111111111
111111111111111111111111111111111111111111111111111111111111111111111111111111111111111111111111111111111111111111
111111111111111111111111111111111111111111111111111111111111111111111111111111111111111111111111111111111111111111
111111111111111111111111111111111111111111111111111111111111111111111111111111111111111111111111111111111111111111
111111111111111111111111111111111111111111111111111111111111111111111111111111111111111111111111111111111111111111
111111111111111111111111111111111111111111111111111111111111111111111111111111111111111111111111111111111111111111
111111111111111111111111111111111111111111111111111111111111111111111111111111111111111111111111111111111111111111
111111111111111111111111111111111111111111111111111111111111111111111111111111111111111111111111111111111111111111
111111111111111111111111111111111111111111111111111111111111111111111111111111111111111111111111111111111111111111
111111111111111111111111111111111111111111111111111111111111111111111111111111111111111111111111111111111111111111
111111111111111111111111111111110000111111111111111111111111111111111111111111111111111111111111111111111111111111
111111111111111111111111111000000000111111111111111111111111111111111111111111111111111111111111111111111111111111
111111111111111111111111111000000000111111111111111111111111111111111111111111111111111111111111111111111111111111
111111111111111111111111111010000000011111111111111111111111111111111111111111111111111111111111111111111111111111
111111111111111111111111110000000000011111111111111111111111111111111111111111111111111111111111111111111111111111
111111111111111111111000000000000000011111110001111111111111111111111111111111111111111111111111111111111111111111
111111111111111111000000000000000000000111111000111111111111111111111111111111111111111111111111111111111111111111
111111111111110000000000000000000000000111110010000000000000000000011111111111111111111111111111111111111111111111
111111111110000000000000000000000000000000000000000000000000000000000111111111111111111111111111111111111111111111
111111110000000000000000000000000000000000000000000000000000000000000001111111111111111111111111111111111111111111
111111100000000000000000000000000000000000000000000000000000000000000000000001111111111111111111111111111111111111
111111000000000000000000000000000000000000000000000000000000000000000000000000000001111001111111111111111111111111
111110000000000000000000000000000011000000000000000010000000000000000000000000000000000000011111111110000011111111
111100000010000000000000000000000000000000000000000000000000000000000000000000000000000001000011111000000001111111
111100000000000010000000000000000000000000000000000000000000000000000000000000000000000000000000001110000000111111
111100000000000000000000000000000000000000000000000000000000000000000000000000000000000000000000001110000000000111
111000000000000000000000000000000000000000000000000000000000000000000000000000000000000000000011111110000000000111
111000000000000000000000000000100000000000000000000000000000000000000000000000000000000000000011111111111111000111
111000000000000000000000000000000010000000000000000000000000000000000000000000000000000000000010000111111111000000
111000000000000000000000000000000000000000000000000000000000000000000000000000000000000000000000000000000001000000
111000000000000000000000000000000000000000000000000000000000000000000000000000000000000000000000000000000000100000
111000000000000000000000000000000000000000000000000000000000000000000000000000000000000000000000000000000000010000
111000000000000000000000000000000000000000000000000000000000000000000000000000000000000000000000000000000000001000
110000000000000000000000000000000000000000000100000000000000000000000001000000000000000000000000000000000000000100
110000000000000000000000000000000000000000000000000000000000001100000000000000000000000000000000000000000000000011
110000000000000000000000000000000000000000000000000000000000000000000000000000000000000000000000000000000000000001
110000000000000000000000000000000000000000000000000000000000000000000000000000000000000000000000000000000000000001
100000000000000000000000000000000000000000000000000000000000000100000000000000000000000000000000000000000000000001
100000000000000000000000000000000000000000000000000000000000000000000000000000000000000000000000000000000000000001
100000000000000000000000000000000000000000000000000000000000000000000000000000000000000000000000000000000000000001
100000000000000000000000000000000000000000000000000000000000000000000000000000000000000000000000000000000000000001
111111100000000000000000000000000000000000000000000000000000000000000000000000000000000000000000000000000000000001
111111111111111000000000000000000000000000000000000000000000000000000000000000000000000000000000000000000000000001
111111111111111000000000000100000000000000000000000000000000000000000000000000000000000000000000000000000000000001
111111111111111000000000000000000000000000000000000000000000000000000000011000000000000000000000000000000000000001
111111111111111000000000000000000000000000000000000000000000000000000000011000000000000000000000000000000000000001
111111111111111100000000000000000000000000000000000000000000000000000000000000000000000000000000000000000000000001
111111111111111110000000000000000000000000000000000000000000000000000000000000000000000000000000000000000000000001
111111111111111110000000000000000000000000000000000000000001000000000000000000000000000000000000000000000000000001
111111111111111110000000000000000000000000000000000000000000000000000000000000000110000000010000000000000000000001
111111111111111110000000000000000000000110000000000100000000000000000000000000000000000000000000000000000000000001
111111111111111111100000000000000000000000000000000000000000000000000000000000000000000000000000000000000000000001
111111111111111110000000000000000000000000000000000000000000000000000000000000000000000000000000000000000000000001
111111111111111110000000000000000000000000000000000000000000000000000000000000000000000000000000000000000000000001
111111111111111110000000000000000000000000000000000000000000000000000000000000000000000000000000000000000000000001
111111111100011110000000000000000000000000000000000000000000000000000000000000000000000000000000000000000000000001
111111111100000000000000000000000000000000000000000001111111100000000000000000000000000000000000000000000000000001
111111001100000000000000000110000000000000000000000001111111000000000000000000000000000000000000000000000000000001
111100000000000000000000000000000000000000000000000000011111000000000000000000000000000000000000000000000000000001
111100000011000000000000000000000000000000000000000000000011000000000000000000000000000000000000000000000000000011
111111000000000000000000000000000000000000000000000000001000000011000000000000000000000000001000000000000000000011
111111000000000000000000000000000000000000000000000000000000000011000000000000000000000000000000000000000000000111
111111000000000000000000000000000000000000000000000000000000000000000000000000000000000000000000000000000000000111
111110000000000000000000000000000000000000000000000000000000000000000000000000000000000000000000000000000000000111
111100000000000000000000000000000000000000000000000000000000000000000000000000000000000000000000000000000000001111
111100000000000000000000000000000000000000000000000000000000000000000000000000000001111111100000000000000000000111
111100000000000000000000000000000000000000000000000000000000000000000000000000000001111111100000000000000000000111
111000000000000000011000000000000000000000000000100000000000000000000000000000000001111111100000000000000000000111
111100000000000000000000000000000000000000000000000000000000000000000000000000000000000000000000000000000000001111
111000000000000000000000000000000000000000000000000000000000000000000000000000000000000000000000000000000000011111
110000000000000000000100000000000000000000000000000000000000000000000000000000000000000000000000000000000000011111
110000000000000000000000000000000000000000000000000000000000000000000011111111110000000000000000000000000000011111
110000000000000000000000000000000000000000000000000000000000000000000011111111110000000000000000000000000000011111
111000000000000000000000000000000000000000000000000000000000000000000011111111110000000000000000000000000000011111
111000000000000000000000000000000000000100000000000000000000000000000011111111110000000000000000000000000000011111
111000000000000000000000000000000000000000000000000000000000000000000000000000000000000000000000000000000000001111
111000000000000000000000000000000000000110000000000000000000000000000000000000000000000000000000000000000000001111
111100000000000000000000000000000000000000000000000000000000000000000000000000000000000000000000000000000000001111
111100000000000000000000000000100000000000000000000000000000000000000000000000000000000000000000000000000000001111
111100000000000000000000000000000000000000000000000000000000000000000000000000000000000000000000000000000000001111
111110000000000000000000000000000000000000000000000000000000000000000000000000000000000000000000000000000000001111
111110000000000000000000000000000000000000000000000000000000000000000000000000000000000000000000000000000000001111
111111000000000000000000000000000000000000000000100000000100000000000000000000000000000000000000000000000000001111
111111000000000000000000000000000000000000000000000000000000000000000000000000000000000000000000000000000000001111
111111000000000000000000000000000000000000000000000000000000000000000000000000000000000000000000000000000000001111
111111000000000000000000000000000000000000000000000000000000000000000000000000000000000000000000000000000000001111
111111000000000010000000000000000000000000000000000000000000000000000000000000000000000000000000000000000000011111
111111000000000000000000000000000000000000000000000000000000000000000000000000000000000000000000000000000000011111
111111000000000000000000000000000000000000000000000000000000000000000000000000000000000000000000000000000000111111
111111000000000000000000000000000000000000000000000000000000000000000000000000000000000000000000000000000000111111
111111000000000000000000000000000000000000000000000000000000000000000000000000000000000000000000000000000001111111
111111100000000000000000000000000000100000001100000000000000000000000000000000000000000000000000000000000001111111
111111111000000000000000000000000000000000001100000000000000000000000000000000000000000000000000000000000011111111
111111111111000000000000000000000000000000000000000000000000000000000000000000000000000000000000000000000011111111
111111111111111111111111100000000000000000000000000000000000000000000000000000000000000000000000000000000111111111
111111111111111111111111111110000000000000000000000001100000000000000000000000000000000000000000000000001111111111
111111111111111111111111111111100000000011111111111111111000000000000000000000000000000000000000000000001111111111
111111111111111111111111111111111111111111111111111111111110000000000000000000000000000000000000000000001111111111
111111111111111111111111111111111111111111111111111111111111100000000000000000000000000000000000000000001111111111
111111111111111111111111111111111111111111111111111111111111111111111111111111111111111111111111110000111111111111
